███████████████████████████████████████████████████████████████████████████████
███    ████                 ██           ████              ██               ███
███    ████                 ██           ████                               ███
███    ████    ███     ███████████    ████████████    ███     █████████     ███
███            ███     ██                      ███    ███     ███   ███     ███
██████████████████     ██       ███████        ██████████     ███           ███
███            ███     ██   ██       ██                       ███           ███
███            ███     ██████████    ████████████████████████████     █████████
███     ███            ██                                     ███           ███
███     ███            ██                                     ███           ███
███     █████████████████    █████    ██████████████████      █████████     ███
███     ███                     ██    ███            ███      ███           ███
███     ███                     ██    ███            ███      ███           ███
███     ███    ███████████      ██    ███     ███    ████████████           ███
███     ███        ███          ██    ███     ███             ███           ███
███     ███        ███          ██    ███     ███             ███    ██████████
███     ███        ███     ██████████████     ███████████     ███    ███    ███
███     ███████    ███     ███        ███             ███     ███    ███    ███
███         ███    ███     ███        ████████████    ███     ███    ███    ███
█████████   ███    ███     ███   ██   ███             ███     ███    ███    ███
███         ███    ███     ███   ██   ███      ██████████     ███    ███    ███
███     ███████    ███     ███   ██   ███    ███      ███     ███    ███    ███
███     ███        ███           ██         ██        ███     ███           ███
███                ███           ██                   ███  Y                ███
███████████████████████████████████████████████████████████████████████████████