███████████████████████████████████████████████████████████████████████████████
███         ███                                 ███                         ███
███  ████   ███    ████████████      █████████  ███    ███    ███████████   ███
███  ████   ███         ███          ████       ███    ███    ███           ███
███  ████   ██████  ██  ███    ██████████  ████████    ███    █████████████████
███  ████       ██  ██  ███          ████  ███         ███                  ███
███  █████████  ██  ██  ███████████  ████  ███  ██████████████████████████  ███
███  ████  ███  ██  ██         ████  ████  ███  ███                         ███
███  ████  ███  ██  ███████████████  ████  ████████    ██████████████████   ███
███  ████  ███  ██  ██         ████  ████              ███                  ███
███  ████  ███  ██  ██  ███    ████  ████  ███████████████████████  ███████████
███  ████  ███  ██  ██  ███    ████  ████  ████                ███          ███
███  ████  ███  ██  ██  ███  ██████  ████  ████   █████████    ███████████  ███
███  ████  ███  ██  ██  ███        Y ████  ████   ███   ███                 ███
███  ████  ███  ██  ███████████████████████████   ███   █████████████████   ███
███  ████               ███                       ███                ████   ███
███  ███████████████    ███   █████████████████████████████    ███   ████   ███
███  ████        ███    ███   ████                             ███   ████   ███
███  ████  ███   █████  ███   ████    ███████████████████████████████████   ███
███  ████  ███   ███    ███   ██████               ████                     ███
███  ████  ███   ███  █████   ████    ██████████   ████   █████████████████████
███  ████  ███   ███          ████          ████   ████                     ███
███  ████  ███   ██████████   ██████████████████   █████████████████████    ███
███        ███          ███                                          ███    ███
███████████████████████████████████████████████████████████████████████████████