███████████████████████████████████████████████████████████████████████████████
███         ███                                 ███                         ███
███   ██    ███    ████████████      ██████     ███    ███    ███████████   ███
███   ██    ███         ███          ██         ███    ███    ███
███   ██    ████████    ███    ████████    ████████    ███    █████████████████
███   ██         ███    ███          ██    ██          ███                  ███
███   ████████   ███    ██████████   ██    ██    ████████████████████████   ███
███   ██   ███   ███           ███   ██    ██    ██                         ███
███   ██   ███   █████████████████   ██    ████████    ██████████████████   ███
███   ██   ███   ███           ███   ██                ███                  ███
███   ██   ███   ███    ███    ███   ██    ███████████████████████     ████████
███   ██   ███   ███    ███    ███   ██    ███                 ███          ███
███   ██   ███   ███    ███    ███   ██    ███    █████████    ████████████████
███   ██   ███   ███    ███          ██    ███    ███   ███                 ███
███   ██   ███   ███    ██████████████████████    ███   ████████████████    ███
███   ██                ███                       ███                ███    ███ 
███   ██████████████    ███    ████████████████████████████    ███   ███    ███
███   ██         ███    ███    ███                             ███   ███    ███
███   ██   ███   ███    ███    ███    ██████████████████████████████████    ███ 
███   ██   ███   ███    ███    ███                 ███                      ███
███   ██   ███   ███    ███    ███    █████████    ███    █████████████████████      
███   ██   ███   ███    ███    ███          ███    ███                      ███
███   ██   ███   ██████████    ████████████████    █████████████████████    ███
███        ███                                                       ███    
███████████████████████████████████████████████████████████████████████████████