███████████████████████████████████████████████████████████████████████████████
█                                                            █                █
█   ██████████████████████████   ████████████████   ██████   █    █   ██████  █
█            █               █   █   █          █        █   ██████   █    █  █
██████████████   █████████   █       █    ██    █████    █            █       █
█            █   ██     ██   █████████    ██    █        ██████████████████████
█   ██████   █   ██     ██                ██        █    █                    █
█   █    █   █   ██     █████████    █    ████████████████   ██████████████   █
█   █    █                     ██    █                   █       █        █   █
█   █    ████████████████████████    ██████    ██████    █████   ███      █   █
█            █       █ Y       ██        ██        ██       ██         █  █   █
█████████    █   █   █   █     █████     █████     █████    ████   ████████   █
█      ██    █   █   █   █               ██           ██           █      █   █
█   █████    █   █       ██████████████████████████   ██████████████      █   █
█   █        █   █████████                    █                        █  █   █
█   █                █  █     █████████████   █    ████████    ████████████   █
█   █   ██████████   █  █     █           █   █    █      █       █           █
█   █   ██           █  █     █      █    ██████████      █████████    ████████
█   █   ██████████████  ██████████████        █                   █           █
█                  █    █    █              █████        ██████████        █  █
████████████████   █    █    █   █████      █   █        █            ██████  █
█              █   █             █   █      █   █        █   █████    █       █
█   █     ██████   ██████      ███   █    ███   ████     █   █   █    █████████
█   █                          █     █                           █            █
███████████████████████████████████████████████████████████████████████████████
