███████████████████████████████████████████████████████████████████████████████
██                          ██   ██   ██             ██       ██             ██
██   ██     Y████████████   ██   ██   ██   ████████      ██   ██   ██   ██   ██
██   ██           ██   ██   ██   ██              ██      ██   ██   ██   ██   ██
██   ███████  ██  ██   ██   ██   ██████████████████████████   ██   ██   ██   ██
██        ██  ██  ██   ██   ██        ██                           ██   ██   ██
██████    ██  ██  ██   ██   ███████   ██  █████████   ███████████████   ██   ██
██        ██  ██  ██        ██        ██  ██     ██   ██   ██           ██   ██
██   ███████████  ████████████    ██████  ██  █  ██   ██   ██   ██████████   ██
██     █  ██                ██    ██      ██  █  ██   ██   ██   ██           ██
████   █  ██  ███████████   ██    ██   █████  █  ██   ██   ██   ██   ██████████
██     █  ██  ██       ██   ██    ██   ██     █  ██   ██        ██           ██
██  █  █      ██   █   ██   ██    ██   ██   ███  ██   █████████████████████  ██
██  █  █████████   █   ██         ██   ████████  ██   ██        ██       ██  ██
██  █              █   █████████████   ██        ██   ██   ██   ██   ██████  ██
██  ████████████████                   ██   ███████   ██   ██   ██           ██
██  █       ██     ██████████████████████     ██      ██   ██   ███████████  ██
██     ██   █████  █       ██          ██     ██   █████   ██   ██       ██  ██
██     ██          █   ██      █████   ██     ██   ██      ██   ██   ██  ██████
██  ████████████████   ██    ███  ██   ██     ██   ██████████   ██   ██      ██
██     ██              ██         ██          ██   ██           ██   ████    ██
██     ██     ██████████████████████████████████   ██   ██████████   ██      ██
██   ████     ██       ██         ██               ██                ██   █████
██   ██           ██        ██            ██████            ██       ██      ██
███████████████████████████████████████████████████████████████████████████████